11111111111111111111111111111
1P000001000100010101010111001
100111100M0100101000100C01101
100010001010M0100101M00001001
100001C00011110M0001000101001
101100C0100010001100001110101
1000M01000CCC00M001000M001111
11110011111111000111111111011
10000001000100010101010111001
100111100M0100101000100C01101
100010001010M0100101M00001001
100001C00011110M0001000101001
101100C0100010001100001110101
1000M01000CCC00M001000M001111
11111111000111100111110000111
100000010001C0010101010111001
100111100M0100101000100C01101
100010001010M0000101M00001001
100001C00011110M0001000101001
101100C0100010001100001110101
1000M01000CCC00M001C0000E1111
11111111111111111111111111111
