1111111
1C0E1P1
1000011
1000001
1111111