1111111111111111
10000000C0000001
1P0E00000000C001
1000100000000001
100000CC000C0001
1111111111111111
