1111111111111111
1000000000000001
1P0E000000000001
1000100000000001
10000000000C0001
1111111111111111
