11111111111111111111111111111
1P000001000100010101010111001
100111100M0100100000000C01101
100010001010M0100001M00001001
101100C0100010001100001110101
1000M01000CCC00M001000M001111
11110010010001000100001111011
10000001000100010101010111001
100111100M0000101000100C01101
100010001010M0100101M00001001
100001C00011110M0001000101001
101100C0100010001100001110101
1000M01000CCC00M001000M001111
11000001000111100100010000111
100000010001C0010101010111001
100110000M0100101000100C01101
100010001010M0000101M00001001
100001C00011110M0001000101001
101100C0100010001100001110101
1000M01000CCC00M001C0000E1111
11111111111111111111111111111
